############################################################################
#                                                                          #
#                                                                          #
#                                                                          #
#                                                                          #
#                                                                          #
#                                                                          #
#                                                                          #
#                                                                          #
#                                                                          #
#                          MAP UNAVAILABLE                                 #
#                                                                          #
#                                                                          #
#                                                                          #
#                                                                          #
#                                                                          #
#                                                                          #
#                                                                          #
#                                                                          #
#                                                                          #
#                                                                          #
#                                                                          #
############################################################################
