############################################################################
##   YOU ARE HERE    #######################################################
########..@..#####################################..####### ISLA ###########
######.........######################################..###### CRUCES #######
########....#########################################.##.X##################
####################### ISLE DE ####################..######################
########################### MUERTAA #######################..###############
###############..........###################################################
#############...   ....   ..################################################
############.....x .....X ...###############################################
#############.....!    .....##....############################.#############
###############.........+...#...############################.###############
#################....^....##xxx#############################################
#############..##########XX###########################...++....#############
################################################..!.................########
#########...#### TREASURE #########################........^..##############
#####.++.....########## ISLAND #############....X.....######### PORT #######
##########..........^..######################################### ROYAL #####
#####.......................################################################
##....................*..........###########################################
#####...!............................#######################################
######.......X.............!......##########################################
############################################################################
